/Users/jimkarpodinis/Downloads/DSML/NLP/NLP_lab1/data/spell_test.txt
contenpted -> specialist: contented
contende -> sarasota: contented
contended -> semicircle: contented
contentid -> semblance: contented
begining -> nineteen: beginning
problam -> saracen: problem
proble -> merari: problem
promblem -> meridian: problem
proplen -> barbara: problem
dirven -> esaias: driven
exstacy -> ascribe: ecstasy
ecstacy -> richest: ecstasy
guic -> caes: juice
juce -> asa: juice
jucie -> hosea: juice
juise -> deci: juice
juse -> ici: juice
localy -> aeneas: locally
compair -> sunrise: compare
pronounciation -> representatives: pronunciation
transportibility -> europharmaceutical: transportability
miniscule -> perennial: minuscule
independant -> retaliation: independent
independant -> retaliation: independent
aranged -> easiest: arranged
arrainged -> innermost: arranged
poartry -> menahem: poetry
poertry -> ariadne: poetry
poetre -> amasai: poetry
poety -> beare: poetry
powetry -> menahem: poetry
leval -> arena: level
basicaly -> recesses: basically
triangulaur -> intercourse: triangular
unexpcted -> reasoning: unexpected
unexpeted -> comissaria: unexpected
unexspected -> registration: unexpected
stanerdizing -> aristocratic: standardizing
varable -> elioenai: variable
futher -> virtue: further
monitering -> occasioned: monitoring
biscits -> leclerc: biscuits
biscutes -> decision: biscuits
biscuts -> leclerc: biscuits
bisquits -> leclerc: biscuits
buiscits -> artistic: biscuits
buiscuts -> artistic: biscuits
avaible -> elealeh: available
seperate -> caesarea: separate
neccesary -> mattaniah: necessary
necesary -> missiles: necessary
neccesary -> mattaniah: necessary
necassary -> masculine: necessary
necassery -> musicians: necessary
neccasary -> consecrate: necessary
defenition -> treasurers: definition
receit -> easier: receipt
receite -> easiest: receipt
reciet -> isaac: receipt
recipt -> isaac: receipt
remine -> panama: remind
remined -> asiatic: remind
inetials -> elioenai: initials
inistals -> teachest: initials
initails -> american: initials
initals -> america: initials
intials -> eminent: initials
magnificnet -> noiselessly: magnificent
magificent -> prophesied: magnificent
magnifcent -> indonesias: magnificent
magnifecent -> audiovisual: magnificent
magnifiscant -> wretchedness: magnificent
magnifisent -> emergencies: magnificent
magnificant -> nonetheless: magnificent
annt -> emma: aunt
anut -> ears: aunt
arnt -> ears: aunt
intial -> achaia: initial
ther -> stra: there
experances -> israelitish: experiences
biult -> peres: built
totaly -> redeem: totally
undersand -> reconcile: understand
undistand -> berechiah: understand
southen -> ceasars: southern
definately -> treasuries: definitely
difinately -> treasuries: definitely
fisited -> decease: visited
viseted -> because: visited
vistid -> becher: visited
vistied -> fearest: visited
volantry -> breeches: voluntary
ment -> name: meant
recieve -> austria: receive
sorces -> amasai: sources
wether -> virtue: whether
usefull -> italian: useful
litriture -> assassins: literature
valubale -> bezaleel: valuable
valuble -> oceania: valuable
desicate -> countess: desiccate
dessicate -> tanzanian: desiccate
dessiccate -> concession: desiccate
clearical -> tennessee: clerical
spledid -> cabinet: splendid
splended -> implicit: splendid
splened -> asiatic: splendid
splended -> implicit: splendid
beetween -> nigerias: between
completly -> sanballat: completely
acount -> esaias: account
cemetary -> sanguine: cemetery
semetary -> canadians: cemetery
speaical -> caresses: special
specail -> abishai: special
specal -> ceases: special
speical -> classes: special
lates -> verac: latest
latets -> isaac: latest
latiest -> receiue: latest
latist -> aeneas: latest
perhapse -> maaseiah: perhaps
rember -> moonie: remember
remeber -> prairie: remember
rememmer -> elioenai: remember
rermember -> nationale: remember
chaper -> steele: chapter
chaphter -> unimedia: chapter
chaptur -> storage: chapter
cak -> sea: cake
vairious -> fettered: various
febuary -> harriet: february
pertend -> maurice: pretend
protend -> maurice: pretend
prtend -> became: pretend
pritend -> seaside: pretend
chosing -> stained: choosing
rote -> area: wrote
wote -> sara: wrote
particulaur -> ministration: particular
awfall -> cheere: awful
afful -> neere: awful
arragment -> nethinims: arrangement
chalenges -> steelkilt: challenges
chalenges -> steelkilt: challenges
lagh -> aice: laugh
lauf -> aiah: laugh
laught -> aileth: laugh
lugh -> erie: laugh
ofen -> avia: often
offen -> rehum: often
offten -> revise: often
ofton -> rehum: often
somone -> cinema: someone
personnell -> maturities: personnel
uneque -> amasa: unique
diagrammaticaally -> europharmaceutical: diagrammatically
discription -> capitalised: description
poims -> basic: poems
pomes -> mania: poems
perple -> sierra: purple
perpul -> sierra: purple
poarple -> rainier: purple
descide -> causeth: decide
articals -> indosuez: articles
possition -> leicester: position
extented -> iscariot: extended
hierachial -> terminates: hierarchal
realy -> niece: really
relley -> esaias: really
relly -> aires: really
voteing -> easiest: voting
comittee -> superior: committee
wantid -> secret: wanted
wonted -> heauie: wanted
benifits -> northern: benefits
defenitions -> illustrated: definitions
scisors -> assured: scissors
sissors -> cecilia: scissors
levals -> albeit: levels
paralel -> measure: parallel
paralell -> miseries: parallel
parrallel -> retaliate: parallel
parralell -> retaliate: parallel
parrallell -> minorities: parallel
accomodation -> international: accommodation
acommodation -> inconvenient: accommodation
acomodation -> unrealistic: accommodation
planed -> enemie: planned
hierchy -> telesis: hierarchy
transfred -> berechiah: transferred
muinets -> niagara: minutes
aranging -> earliest: arrangeing
accesing -> issuance: accessing
stomac -> cranes: stomach
stomache -> chapiter: stomach
stomec -> chinas: stomach
stumache -> chapiter: stomach
unfortunatly -> achievements: unfortunately
conciderable -> indianapolis: considerable
acess -> isaac: access
singulaur -> damnation: singular
scarcly -> cheeses: scarcely
scarecly -> diseases: scarcely
scarely -> initial: scarcely
scarsely -> coincide: scarcely
questionaire -> constrained: questionnaire
experance -> israelites: experience
experiance -> israelites: experience
possable -> bacteria: possible
reafreshment -> predestinated: refreshment
refreshmant -> pleasantness: refreshment
refresment -> pleasanter: refreshment
refressmunt -> pleasantness: refreshment
embaras -> indiana: embarrass
embarass -> announce: embarrass
vistors -> wearied: visitors
auxillary -> essential: auxiliary
descided -> trustest: decided
benifit -> dimness: benefit
concider -> scenario: consider
failes -> heroic: fails
carrer -> senile: career
occurence -> austerity: occurrence
occurence -> austerity: occurrence
cirtain -> searles: certain
poame -> arena: poem
liew -> aero: lieu
astablishing -> independence: establishing
establising -> accelerated: establishing
diffrent -> nehemiah: different
lones -> isaac: loans
extreamly -> associate: extremely
addresable -> occasional: addressable
galery -> isaiah: gallery
gallary -> deities: gallery
gallerry -> initiate: gallery
gallrey -> israeli: gallery
centraly -> nominees: centrally
familes -> venetian: families
bicycal -> venison: bicycle
bycicle -> pesetas: bicycle
bycycle -> visited: bicycle
choise -> strata: choice
opisite -> electro: opposite
oppasite -> remotest: opposite
oppesite -> armacost: opposite
oppisit -> abiezer: opposite
oppisite -> armacost: opposite
opposit -> abiezer: opposite
oppossite -> americans: opposite
oppossitte -> ameritrust: opposite
cartains -> seasoned: curtains
certans -> sincere: curtains
courtens -> salaried: curtains
cuaritains -> irrational: curtains
curtans -> seismic: curtains
curtians -> seasoned: curtains
curtions -> tendered: curtains
adress -> isaac: address
adres -> ittai: address
liaision -> releases: liaison
liason -> easier: liaison
managment -> nethinims: management
inconvienient -> renegotiation: inconvenient
inconvient -> assemblies: inconvenient
inconvinient -> satisfaction: inconvenient
vairiant -> beauties: variant
supercede -> comissaria: supersede
superceed -> collision: supersede
Accuracy: 0.0
